Ausblick: Wie weiter?
Perspektiven fьr eine stдrkere Antikriegsbewegung
Christian Strцbele: Parlamentarische Mehrheiten gegen den Krieg                  schaffen
Franziska Drohsel: Jugendorganisationen gegen den Krieg
Hanna Poddig: Strategien des politischen Aktivismus
Bernd Drьcke: Perspektiven des libertдren Antimilitarismus
Workshops
Lьhr Henken/Nassauer: Nahoststrategie der NATO
Tobias Pflьger: EU-Militarisierung
Jьrgen Wagner: Wirtschaftsinteressen und ьbergeordnete Motive
Hцrstel: "Krieg gegen den Terrorismus"
Christine Buchholz: aktuelle Situation in Afghanistan
Matin Baraki: Deutschlands Interessen im Nahen Osten
von Bьlow (angefragt): vцlkerrechtliche Aspekte des Afghanistan-Einsatzes
Dr. Behrooz Abdolvand: US Iran Politik: "No Options Are on                    the Table"
Nahed Samour, Iris Hefets: Israel/Palдstina
Wikileaks-Mitglied (angefragt): ьber die Wikileaks-Dokumente                    zu Afghanistan
Andrй Shepherd (angefragt): Erfahrungsbericht eines Irak-Deserteurs
Studi: Kampf fьr Zivilklauseln organisieren
Schьler_innen von Klassenkampf Sьd/West: Wie Protest gegen                    BW an der Schule organisieren?
GEW: Was will die BW an der Schule?
Warum Nachwuchswerbung?
Gцssner: Militдrischer Heimatschutz.
Neue Sicherheitsarchitektur                    fьr den alltдglichen Ausnahmezustand?
Sabine Schiffer: Antimuslimischer Rassismus und Frauenrechte                    als Kriegslegitimation
Schiffer: Kriegsberichterstattung in den Medien
DFG-VK/Drohsel (Jusos): Rьstungsindustrie und ihre globalen                    Interessen
Poddig u. ALB: ziviler Ungehorsam als Strategie des Antimilitarismus
Werner Ruf: Der Krieg von morgen - Afrika im Visier der USA
Bernd Drьcke: Perspektiven des libertдren Antimilitarismus
Ricardo Cristof Remmert-Fontes (angefragt): Frontex, "Krieg                    gegen Menschen an Europas Grenzen"
Peter Klemm: 100% erneuerbare Energie ist ein Gebot der Friedenspolitik
Walter Magne Veliz, Erdcharta (angefragt): Boliviens Vorschlag                    fьr Frieden aus der tausendjдhrigen Erfahrung der Andenkultur                    und weitere in Planung
Auяerdem: Info- & Bьchertische; Fotoausstellung zu Afghanistan;                  Open Space fьr spontane Diskussionsrunde
